Orth	Phon
ހ	h
ށ	ʂ
ނ	n
ނބ	ᵐb
ނދ	ⁿd̪
ނގ	ᵑg
ނޑ	ᶯɖ
ރ	ɾ
ބ	b
ޅ	ɭ
ކ	k
އ	_
ވ	ʋ
މ	m
ފ	f
ދ	d̪
ތ	t̪
ލ	l
ގ	ɡ
ޏ	ɲ
ސ	s
ޑ	ɖ
ޒ	z̺
ޓ	ʈ
ޔ	j
ޕ	p
ޖ	d͡ʒ
ޗ	t͡ʃ
ޘ	θ
ޙ	ħ
ޚ	x
ޛ	ð
ޜ	ʒ
ޝ	ʃ
ޞ	sˤ
ޟ	dˤ
ޠ	tˤ
ޡ	ðˤ
ޢ	ʕ
ޣ	ɣ
ޤ	q
ޥ	w
ޱ	ɳ
ަ	a
ާ	aː
ި	i
ީ	iː
ު	u
ޫ	uː
ެ	e
ޭ	eː
ޮ	o
ޯ	o̞ː
ް	_
އް	ʔ
ށް	ʔ
ތް	jʔ
ަތް	æʔ
ާތް	æ:ʔ
ން	ŋ
ންޖ	ɲd͡ʒ
ންޗ	ɲt͡ʃ
ންހ	ŋh
ންގ	ŋɡ
ންކ	ŋk
ންއ	ŋ
ންދ	nd̪
ންތ	nt̪
ންޑ	ɳɖ
ންޓ	ɳʈ
ންބ	mb
ންޕ	mp
ންވ	ɱʋ
ންފ	ɱf
ންނ	nn
ންމ	mm
ސް	s
